######################################################################################################################
###          ##        ##########         ##########     #####                   #######         #####################
############    ######            ####### ####       ### ##### ################# ####### ####### #####          ######
###################### ################## #### #########                    #### ####### ####### ############## ######
###                ### #########     #### #### ############################ #### ### ### #######          ##### ######
### ############## ###      #### ### #### #### #####          ############# #### ### ### #### ###########       ######
###        ####### ######## #### ### ####      ##### ######## ############# #### ### ### #### ########### ############
########## ####### ######## #### ### ###### ######## ######## ############# ####                  ####### ############
#####      #####     ###### #### ### ###    ######## ########               ######### ########### #######       ######
##### ########## ### ######      ### ### ########### ################################ ########### ############# ######
##### ########## ### ######## ###### ### ###                ### #####################        ####    ########## ######
##### ########## ###          ###### ### ### ############## ### ####           ############# #### #####         ######
##### ########## ################### ###     ############## ### #### ######### ####          #### ##### ####### ######
##### ##########     ##              #######            ### ### #### ######### ################## ##### ####### ######
##### ####       ### ## ############################### ### ### #### #########                    ##### ####### ######
#####      ######### ## ###################      ###### ### ### #### #####################################      ######
########## #####     ##                #### #### ###### ###     #### ##################                ### ###########
########## ##### ########### ######### #### #### ###### ### ######## ################## ############## ### ###########
#####      #####          ## ######### #### ####        ### ########                                 #     ###########
##### #### ############## ## ######### #### ######## ###### ######################################## ##### ###########
##### #### ############## ## #########      ######## ######          ############################### ##### ###########
##### ####            ###    ####################### ###### ######## ####       #### ############### ##### ###########
##### ############### ############################## ###### ########      ##### #### ############### ##### ###########
##### ############### ######               ######### ###### ############# ##### ####                 #####      ######
##### ############### ###### ############# ######### ######        ###### ##### ######### ##################### ######
#####     ########### ###### ############# ######### ############# ###### ##### ######### ##################### ######
######### ########### ###### #############           ####   ###### ###    ##### ######### #####           ##### ######
#########             ###### ############################ ######## ### ########           ##### ######### ##### ######
######### ########### ######                       ###### ######## ### ############# ########## ######### ##### ######
######### ########### ############################ ###### ######## ### ############# ########## ######### ##### ######
#########        ####                      ####### ######      ### ### #####         ########## ######### ##### ######
################ ########### ############# ####### ###### #### ### ### ######################## #####     ##### ######
################ ########### ##   ####     ####### ###### #### ### ### ######################## ##### ### ##### ######
################ ########### #### #### ###########        #### ### ###                          ##### ### ##### ######
###########            ##### #### #### ############### ####### ### ##################### #### ####### ### ##### ######
########### ###### ### #####      #### ############### #####   ### ##################### #### ####### ### ##### ######
########### ###### ### ###############                 ##### #####                  #### #### ####### ###       ######
########### ###### ### ####################### ############# ###################### #### #### ####### ###### #########
#####       ###### ### ####################### #############       ####      ###### #### #### ####### ###### #########
##### ##### ###### ###                 ####### ################### #### #### ###### #### #### ####### ###### ##    ###
##### ##### ####   ############# ##### ####### #######             #### #### ###### #### ####         ###    ##### ###
##### ##### #### ############### ##### ####### ####### ##### ############### ###### ####    ############# ######## ###
#####    ## ####                 #####         ####### ##### ####            ###### ####### ############# ######## ###
######## ## ########################################## ##### #### ################# #### ##               ######## ###
######## ##                                 ########## ##### #### ######            #### ################          ###
######## ################################## ########## ##### #### ###### ############### #############################
####     ###############        #### ###### ########## #####      ######                                    ##########
#### ################### ###### #### ######            #################### ####### ############ ##########         ##
####                     ######      ###################################### ####### ############ #####################
######################################################################################################################