######################################################################################################################
##    #######################           ######## #####################################################################
#####             ###### #### ##### ############ ############# ######                      #########              ####
##### ########## ####### #### ##### ########          ######## ######  ########## #### ############# ############ ####
#####       #### ####         #####    ##### ########                  ########## ####          #### ############ ####
########### #### #### ########## ##### ##### ######## ########################### ################## ############ ####
########### ######### ########## ##### ##### ########                     #######                             ########
##### ##### ######### ###              #####       ## ####### ########### ################################### ########
##### ##### ######### ###################### ##### ## ####### ########### ####################### ########### ########
##### #####                                  ##### ## ####### ###########                   #####             ########
##### ###################### ##################### ## #######       ##### ############### ############ ###############
#####       ############          ###########         ####### ########### ###############          ### ###############
########### ############ #################### ############### ########### ############################           #####
########### ####                              ####### #######     #######                     ######## ######### #####
########### #### ####### #################### ####### ########### ############ ###### ####### ######## ######### #####
#######          ####### #################### #######             ############ ###### #######            ####### #####
####### ################ ########             ############ ######              ###### ####### ##### ########     #####
####### ###########      ######## ###########               ################################# ##### ######## #########
####### ######################### ########### #######################                         ##### ######## #########
####### ########                  ####     ##                  ########### ######## ###############     #### #########
################ ######### ###### #### ### ######## ########## ########### ########             ####### #### #########
######           ######### ###### #### ### ######## ########## ########### #################### ####### #### #########
###### ######### ######### ###### #### ### ######## ########## ###########                         ####      #########
###### ######### ######### ###### ######## ######## ####     # ######################### ################### #########
################         # ######                   ######## #                    ###### ################### #########
###            ######### #      ############################ ######### ########## ######                  ## #########
### ########## ######### ###################           ##### ######### ########## ###### ################ ##      ####
### ########## ######### ################### ############### ######### ########## ###### ################ ##### ######
### ####################              ###### ###                  ####       ####               #########       ######
### ###########          ############        ### ################ ############################# ############### ######
###    ###      ##################### ########## ################ #############################                 ######
###### ### #### ############          ########## ################ ####                          #### #################
###### ### #### ################################ ###        ##### #### ####### ######## ####### ####                ##
###### ### #### ################################ ### ############ #### ####### ######## ####### #### ###### ####### ##
######     ####                                  ### ############ #### #######          ####### #### ###### ####### ##
########## ############################# ########### ####         #### ### ####### ############          ## ##      ##
########## ##########            ####### ########### #### ############ ### ####### ############ ######## ##### #######
########## ########## ##################             ####              ###         ############ ######## ##### #######
##########            ################################### ######## ########## #######           ###            #######
##### ######### #####                                     ######## ########## ####### ################## ### #### ####
##### ######### ######################## ###### ##############                ####### ################## ### #### ####
#####       ### ############### ###  ### ######    ################### ## ### ####### #####              ###      ####
##### ##### ###              ## ### #### ###### ######            #### ## ###         ##### ################ ### #####
##### ##### ### ############    ###             ###### ########## #### ## ###### ####                ####### ### #####
##### ######### ###          ############ #####        ####       #### ## ## ### ####### #### ######         ### #####
#####           ### ############### ##### ######## ### ############### ## ## ### ####### #### ###### ########### #####
################### #########       ##### ######## ###                 ##    ### ###     ####    ### #################
###################       #########                ########### ##################### ###############                ##
##############################################################         ###############################################
######################################################################################################################